22222222222222222222222222222222222222222222222222222222222222222222222222222222222222222222222222222
22222222222222222222222222222222222222222222222222222222222222222222222222222222222222222222222222222
22222211111111233331133333333333333333333333322112222331122222222211333322113322223333333322222222222
22222211111111233331133333333333333333333333322112222331122222222211333322113322223333333322222222222
22222211222222233331133000033333333333333333333333333332222222222233333333333322223333333322222222222
22333211233333333332222222222222222222222222333333333332222222222233333333333322223300333322222222222
22333333333333333332222222222222222222222222333333333332222223333333333333333322223300333322222222222
22333333333000033332222222222222222222222222233333333332222223333333333333333322223333333322222222222
22003333333000033332222222222222222222222222233333333332222223333333333300003322223333333322222222222
22103333333000033332222222222222222222222222233333333332222223333322223300003322223333333322222222222
22103333333333333333333333333333333333333322222222233332222223333320023300003322223333333322222222222
22103333333333333333333333333333333333333322222222233332223333333220023300003322223333333322222222222
22333333333333333333333333333333333333333322222222233332223333222220023333333322223333333322222222222
22333333333333333333333333333333333333333322200000033332223333222220023333333322223333333322222222222
22333333333113333333333333333333333333333322200000033332223333333320023333333322223333332222222222222
22333333333113333333333333333333333333333322210000033332223333333320023333333333333333332222221132222
22333333333333333333333333300000033333333322211111133333333330003320023333333333333333332222223332222
22113333333333333333333333300111133333333322210000003333333330003320023333333333333333332233333333222
22113333333333333333333333300111133333333322210000223333333330003320021111111111111111112233333333222
22222222222222222222222222222222222222211122222222223333333333333322223333333333333333332233333333522
22222222222222222222222222222222222222211122222222223333333333333322223333333333333333332233333222222
22233333333333333333333333111333300223333333332222223333333333333322223333333333333333322233333222222
22233333333333333333333333111333300223333333332222221113332223333322223333333332222222222233333222222
22233333333333333333333333111333300223333333332222221113332222222222223332222222222222222200333222222
22233333333333222222222222222333300223333003332222221113332222222222223332222222222222222200111222222
22233333333333200000000000222333300223333003332222222222222222222222223333332222222222222233333222222
22233333333333200000000000222333300223333003332222222222222222223333333333332222222222222233333222222
22233333333223200000000000222333333333333003332222222222222223333330003333332222222222222233333222222
22233333333223200000000000222333333333333333333222222222222223333330003333332222222222222233333322222
22233333333333200000000000222333333333333333333222222222222223333330003333332222222222222222233332222
22233331111333200000000000222333333322222222223222222222222223333333333333332222221222222222233332222
22233331111333200000000000222333333322222222223222222222222223333333333333332222221222222222233332222
22233331111333200000000000222333333322000000223222222222222223333333333333332222221332222222233331222
22233333333222222222222222222333333322000000223222222222222223333333333333332222222332222222233331122
22333333333222333333333333333333333322000000223222222222222223333333333333331111222333333333333322222
22333333333222333331111333333333333322000000223333211112222223333333333333333333222333333333333322222
22332233333222333331111333333222222222000000223333311112222223333333333333333333333333333333333322222
22112233333222333331111333333200000022000000223333311112222221111122222222223333333333333322222222222
22330033333222333331111333333200000022000000223333311112222221111122222222223333333332222222222222222
22330033333222333333333333333200000022000000223333311112222221111122222222223333333332222222222222222
22333033333222333333333333333200000022000000222222222222222222222222222222222222222222222222222222222
22222222222222222222222222222222222222222222222222222222222222222222222222222222222222222222222222222
22222222222222222222222222222222222222222222222222222222222222222222222222222222222222222222222222222
