222222222222222222222222222222222222222222222222222222222222222222222222222222222222222222222222222222
222222233322211122222222222222111332222333333333332222222222222222222222222222222222222222222222222222
222222233322211122222222222222111332222333333333331111122222222222222222222222222222222222222222222222
222222233332211122222222222222223333333333333333331111122222222222222222222222211111003333222222222222
222113333333333333332222222222223333333000003333331111122222222222222222222222211111003333222222222222
225113333333333333333333332232223333333000003333333333332222222222222222222222233333333333222222222222
222113333333300033333333332232223333333000003333333333333333333333322222222222233333333333331133332222
222222233333300033333333333332223333333000003333333333333333333333333333333333333333333333331133332222
222222233333300033331111333332333333333333333333333333333333333333333333333333333333333333331133332222
222222233333333333331111333332333333333333333222222333333333333333333333333333333333333333331133332222
222222233333333333333333333332332222222222333222222333332222222222222222222222333333333333332222222222
222222222222222222223333333332332222222222111222222111112222222222222222222222211111003333333222222222
222222222222222222222222223333332222222222111222222111112222222222222222222222211111003333333222222222
222222222222222222221111333333332222222222222222222222222222222222222222222222222222333333333333222222
222222221112222222221111333333222222222222222222222222222222222222222222222222222222222333333333222222
222222221112222222221111333333222222222222222222222222222222222222222222222222222222222113333333222222
233333333322222222222222222222222222222222222222222222222222222222222222222222222222222113333333222222
233333333333333222222222222222222222222222222222222222222222222222222222222222222222222233333333222222
200033333333333333222222222222222222222233333333333222222222222222222222222222222222222333333333322222
200033330003333333222222222222222222222333333333333222223333333322222222222222222222222233330003322222
200033330003311133322222222222222222222333330003333222223333333322220000022222222222222233330003322222
221133330003311133322222222222222222233333330003333222220003333322222222222222222222222223330003322222
221133333333311133322222222222222222233333222222233333320003333322222222222222222222222223333333322222
222233333333333333322222222222222222233333322222233333323333333333333333333322222222222223333333222222
222233333333333333333333333333333322222233322222222333333333333333333333333322222232222223333333222222
222233333333333333333333333333333322222233322222222333333333333333333333333322222222222222233333222222
222233330003332222333333333333333333322233322222222333332222222223331113333322222222222222233311222222
233333330003332222333322333330003333322233322222222333333322222222331113333333322222222222233311222222
233333330003332222111122333330003333322233333222222333333322222222331113333333322222233333333322222222
233333333333333322111122333333333330022233333222222222223322222222333333333333322222233333332222222222
233322233333333222111122222222333330022233333111222222223322222222333333333333322222233333322222222222
233322232222233222000022222222222233323333333111222222223322222222003333300033333333333333322222222222
233222222222333322222222000022222233323333333111222222223322222222003333300033333333333333333222222222
211112222222333322222222000022222223333333333222222222223322222222333333333333333333333333333332222222
233333222222333322222222000022222223333333333222222222223322222222222222233333333333011110333332222222
233333222200033322222222000022222223333333333222222222223322222222222222222222233333011110333332222222
233333222200033322222222000022222221112222222222222222223322222222222222222222233333011110333332222222
200333222211033322222222000022222221112222222222211133333322222222222222222222233333011110333332222222
222033221111333322222222000022222221112222222222211133333322222222222222222222222222222222222222222222
222033221111333322222222222222222222222222222222211133333322222222222222222222222222222222222222222222
222222222222222222222222222222222222222222222222222222222222222222222222222222222222222222222222222222